neighbors for n00dles: home,zer0
neighbors for zer0: n00dles,neo-net,silver-helix,phantasy,omega-net
neighbors for neo-net: zer0,computek,crush-fitness,avmnite-02h
neighbors for computek: neo-net
neighbors for crush-fitness: neo-net
neighbors for avmnite-02h: neo-net,rothman-uni,syscore,catalyst,I.I.I.I
neighbors for rothman-uni: avmnite-02h,rho-construction
neighbors for rho-construction: rothman-uni
neighbors for syscore: avmnite-02h,aevum-police
neighbors for aevum-police: syscore,aerocorp,snap-fitness
neighbors for aerocorp: aevum-police
neighbors for snap-fitness: aevum-police,omnia,deltaone
neighbors for omnia: snap-fitness,icarus,zeus-med
neighbors for icarus: omnia,nova-med
neighbors for nova-med: icarus
neighbors for zeus-med: omnia,infocomm
neighbors for infocomm: zeus-med,applied-energetics
neighbors for applied-energetics: infocomm,helios
neighbors for helios: applied-energetics
neighbors for deltaone: snap-fitness
neighbors for catalyst: avmnite-02h,millenium-fitness
neighbors for millenium-fitness: catalyst
neighbors for silver-helix: zer0,netlink
neighbors for netlink: silver-helix,summit-uni
neighbors for summit-uni: netlink
neighbors for phantasy: zer0,johnson-ortho
neighbors for johnson-ortho: phantasy
neighbors for omega-net: zer0,the-hub
neighbors for the-hub: omega-net,zb-institute
neighbors for zb-institute: the-hub,lexo-corp,alpha-ent
neighbors for lexo-corp: zb-institute,global-pharm
neighbors for global-pharm: lexo-corp
neighbors for alpha-ent: zb-institute,galactic-cyber
neighbors for galactic-cyber: alpha-ent,unitalife
neighbors for unitalife: galactic-cyber,defcomm,univ-energy,solaris
neighbors for defcomm: unitalife,taiyang-digital
neighbors for taiyang-digital: defcomm,microdyne,run4theh111z
neighbors for microdyne: taiyang-digital,fulcrumtech
neighbors for fulcrumtech: microdyne
neighbors for run4theh111z: taiyang-digital
neighbors for univ-energy: unitalife
neighbors for solaris: unitalife,zb-def
neighbors for zb-def: solaris,titan-labs
neighbors for titan-labs: zb-def,stormtech,vitalife
neighbors for stormtech: titan-labs,.
neighbors for .: stormtech,blade,nwo,clarkinc
neighbors for blade: .,fulcrumassets
neighbors for fulcrumassets: blade
neighbors for nwo: .,The-Cave
neighbors for The-Cave: nwo
neighbors for clarkinc: .
neighbors for vitalife: titan-labs,omnitek,4sigma,kuai-gong
neighbors for omnitek: vitalife,b-and-a
neighbors for b-and-a: omnitek,ecorp
neighbors for ecorp: b-and-a
neighbors for 4sigma: vitalife,powerhouse-fitness
neighbors for powerhouse-fitness: 4sigma,megacorp
neighbors for megacorp: powerhouse-fitness
neighbors for kuai-gong: vitalife
neighbors for foodnstuff: home
neighbors for sigma-cosmetics: home
neighbors for joesguns: home,nectar-net
neighbors for nectar-net: joesguns
neighbors for hong-fang-tea: home,max-hardware,CSEC
neighbors for max-hardware: hong-fang-tea
neighbors for CSEC: hong-fang-tea
neighbors for harakiri-sushi: home
neighbors for iron-gym: home
neighbors for darkweb: home
